###.#####
###.##^..
###....##
....##.##
*##.##..#