............
............
............
............
...*........
............
.........###
.........#^.
.........#..